R 900 400

NO ./textures/mossy.xpm
SO ./textures/redbrick.xpm
WE ./textures/wood.xpm
EA ./textures/stone.xpm

S ./textures/barrel.xpm

F 90,96,90
C 133,196,255

111111111111111111111111111111111
100000000000000000000000000000001
100000000000000010000000000000001
100000000000000101000000000000001
100000022200000010000000000000001
100000021200000000000000020000001
100000022200000000000000000000001
100000000000000000000000000000001  
1000000000000000000000000N0000001  
100000000000000000000000000000001
111111111111111111111111111100001 
122200000000000000000000000000001
122200000000000000000000000000001
122200000000012000000000000000001
122200000000000000000000000000001
122200000000000000000000000000001 
122200000000000000000000000000001
122200000000000000000001200000001
122200000000000000000000000000001
122200000000000000000000000000001
111111111111111111111111111111111